1 1 1 1 1 1 1 1 1 1 1 1 1 1 1 1 1 1 1 1 1 1 1 1 1 1 1 1 1 1 1 1 1 1 1 1 1 1 1 1 1 1 1 1 1 1 1 1 1 1
1 1 1 1 1 1 1 1 1 1 1 1 1 1 1 1 1 1 1 1 1 1 1 1 1 1 1 1 1 1 1 1 1 1 1 1 1 1 1 1 1 1 1 1 1 1 1 1 1 1
1 1 1 1 1 1 1 1 1 1 1 1 1 1 1 1 1 1 1 1 1 1 1 1 1 1 1 1 1 1 1 1 1 1 1 1 1 1 1 1 1 1 1 1 1 1 1 1 1 1
1 1 1 1 1 1 1 1 1 1 1 1 1 1 1 1 1 1 1 1 1 1 1 1 1 1 1 1 1 1 1 1 1 1 1 1 1 1 1 1 1 1 1 1 1 1 1 1 1 1
1 1 1 1 1 1 1 1 1 1 1 1 1 1 1 1 1 1 1 1 1 1 1 1 1 1 1 1 1 1 1 1 1 1 1 1 1 1 1 1 1 1 1 1 1 1 1 1 1 1
1 1 1 1 1 5 0 0 0 2 3 0 0 0 0 5 2 0 0 0 3 0 0 2 0 5 0 0 0 0 3 0 0 0 0 5 0 2 0 0 3 0 0 0 2 1 1 1 1 1
1 1 1 1 1 0 0 0 2 5 3 0 0 0 5 2 0 0 0 5 3 0 2 0 5 0 0 0 0 2 3 0 0 0 5 0 2 0 0 5 3 0 0 2 5 1 1 1 1 1
1 1 1 1 1 0 0 2 5 0 3 0 0 5 2 0 0 0 5 0 3 2 0 5 0 0 0 0 2 0 3 0 0 5 0 2 0 0 5 0 3 0 2 5 0 1 1 1 1 1
1 1 1 1 1 0 2 5 0 0 3 0 5 2 0 0 0 5 0 0 3 0 5 0 0 0 0 2 0 0 3 0 5 0 2 0 0 5 0 0 3 2 5 0 0 1 1 1 1 1
1 1 1 1 1 2 5 0 0 0 3 5 2 0 0 0 5 0 0 2 3 5 0 0 0 0 2 0 0 0 3 5 0 2 0 0 5 0 0 0 3 5 0 0 0 1 1 1 1 1
1 1 1 1 1 3 3 3 3 3 3 3 3 3 3 3 3 3 3 3 3 3 3 3 3 3 3 3 3 3 3 3 3 3 3 3 3 3 3 3 3 3 3 3 3 1 1 1 1 1
1 1 1 1 1 0 0 0 0 5 3 0 0 0 5 0 0 2 0 5 3 4 4 4 4 4 4 4 4 4 3 2 0 0 5 0 0 0 2 5 3 0 0 0 5 1 1 1 1 1
1 1 1 1 1 0 0 0 5 2 3 0 0 5 0 0 2 0 5 0 3 4 4 4 4 4 4 4 4 4 3 0 0 5 0 0 0 2 5 0 3 0 0 5 2 1 1 1 1 1
1 1 1 1 1 0 0 5 2 0 3 0 5 0 0 2 0 5 0 0 3 4 4 4 4 4 4 4 4 4 3 0 5 0 0 0 2 5 0 0 3 0 5 2 0 1 1 1 1 1
1 1 1 1 1 0 5 2 0 0 3 5 0 0 2 0 5 0 0 0 3 4 4 4 4 4 4 4 4 4 3 5 0 0 0 2 5 0 0 0 3 5 2 0 0 1 1 1 1 1
1 1 1 1 1 5 2 0 0 0 3 0 0 2 0 5 0 0 0 0 3 4 4 4 4 4 4 4 4 4 3 0 0 0 2 5 0 0 0 0 3 2 0 0 0 1 1 1 1 1
1 1 1 1 1 2 0 0 0 5 3 0 2 0 5 0 0 0 0 2 3 4 4 4 4 4 4 4 4 4 3 0 0 2 5 0 0 0 0 5 3 0 0 0 5 1 1 1 1 1
1 1 1 1 1 0 0 0 5 0 3 2 0 5 0 0 0 0 2 0 3 4 4 4 4 4 4 4 4 4 3 0 2 5 0 0 0 0 5 2 3 0 0 5 0 1 1 1 1 1
1 1 1 1 1 0 0 5 0 0 3 0 5 0 0 0 0 2 0 0 3 4 4 4 4 4 4 4 4 4 3 2 5 0 0 0 0 5 2 0 3 0 5 0 0 1 1 1 1 1
1 1 1 1 1 0 5 0 0 2 3 5 0 0 0 0 2 0 0 0 3 4 4 4 4 4 4 4 4 4 3 5 0 0 0 0 5 2 0 0 3 5 0 0 2 1 1 1 1 1
1 1 1 1 1 3 3 3 3 3 3 3 3 3 3 3 3 3 3 3 3 4 4 4 4 4 4 4 4 4 3 3 3 3 3 3 3 3 3 3 3 3 3 3 3 1 1 1 1 1
1 1 1 1 1 0 0 2 0 5 3 0 0 0 2 0 0 0 0 5 3 4 4 4 4 4 4 4 4 4 3 0 0 0 5 2 0 0 0 5 3 0 2 0 5 1 1 1 1 1
1 1 1 1 1 0 2 0 5 0 3 0 0 2 0 0 0 0 5 0 3 4 4 4 4 4 4 4 4 4 3 0 0 5 2 0 0 0 5 0 3 2 0 5 0 1 1 1 1 1
1 1 1 1 1 2 0 5 0 0 3 0 2 0 0 0 0 5 0 2 3 4 4 4 4 4 4 4 4 4 3 0 5 2 0 0 0 5 0 0 3 0 5 0 0 1 1 1 1 1
1 1 1 1 1 0 5 0 0 0 3 2 0 0 0 0 5 0 2 0 3 4 4 4 4 4 4 4 4 4 3 5 2 0 0 0 5 0 0 2 3 5 0 0 0 1 1 1 1 1
1 1 1 1 1 5 0 0 0 0 3 0 0 0 0 5 0 2 0 0 3 4 4 4 4 4 4 4 4 4 3 2 0 0 0 5 0 0 2 0 3 0 0 0 0 1 1 1 1 1
1 1 1 1 1 0 0 0 0 2 3 0 0 0 5 0 2 0 0 5 3 4 4 4 4 4 4 4 4 4 3 0 0 0 5 0 0 2 0 5 3 0 0 0 2 1 1 1 1 1
1 1 1 1 1 0 0 0 2 0 3 0 0 5 0 2 0 0 5 0 3 4 4 4 4 4 4 4 4 4 3 0 0 5 0 0 2 0 5 0 3 0 0 2 0 1 1 1 1 1
1 1 1 1 1 0 0 2 0 0 3 0 5 0 2 0 0 5 0 0 3 4 4 4 4 4 4 4 4 4 3 0 5 0 0 2 0 5 0 0 3 0 2 0 0 1 1 1 1 1
1 1 1 1 1 0 2 0 0 0 3 5 0 2 0 0 5 0 0 0 3 4 4 4 4 4 4 4 4 4 3 5 0 0 2 0 5 0 0 0 3 2 0 0 0 1 1 1 1 1
1 1 1 1 1 3 3 3 3 3 3 3 3 3 3 3 3 3 3 3 3 4 4 4 4 4 4 4 4 4 3 3 3 3 3 3 3 3 3 3 3 3 3 3 3 1 1 1 1 1
1 1 1 1 1 0 0 0 0 5 3 2 0 0 5 0 0 0 2 5 3 4 4 4 4 4 4 4 4 4 3 0 2 0 5 0 0 0 0 2 3 0 0 0 5 1 1 1 1 1
1 1 1 1 1 0 0 0 5 0 3 0 0 5 0 0 0 2 5 0 3 4 4 4 4 4 4 4 4 4 3 2 0 5 0 0 0 0 2 0 3 0 0 5 0 1 1 1 1 1
1 1 1 1 1 0 0 5 0 2 3 0 5 0 0 0 2 5 0 0 3 4 4 4 4 4 4 4 4 4 3 0 5 0 0 0 0 2 0 0 3 0 5 0 2 1 1 1 1 1
1 1 1 1 1 0 5 0 2 0 3 5 0 0 0 2 5 0 0 0 3 4 4 4 4 4 4 4 4 4 3 5 0 0 0 0 2 0 0 0 3 5 0 2 0 1 1 1 1 1
1 1 1 1 1 5 0 2 0 0 3 0 0 0 2 5 0 0 0 0 3 4 4 4 4 4 4 4 4 4 3 0 0 0 0 2 0 0 0 0 3 0 2 0 0 1 1 1 1 1
1 1 1 1 1 0 2 0 0 5 3 0 0 2 5 0 0 0 0 5 3 4 4 4 4 4 4 4 4 4 3 0 0 0 2 0 0 0 0 5 3 2 0 0 5 1 1 1 1 1
1 1 1 1 1 2 0 0 5 0 3 0 2 5 0 0 0 0 5 2 3 4 4 4 4 4 4 4 4 4 3 0 0 2 0 0 0 0 5 0 3 0 0 5 0 1 1 1 1 1
1 1 1 1 1 0 0 5 0 0 3 2 5 0 0 0 0 5 2 0 3 4 4 4 4 4 4 4 4 4 3 0 2 0 0 0 0 5 0 2 3 0 5 0 0 1 1 1 1 1
1 1 1 1 1 0 5 0 0 0 3 5 0 0 0 0 5 2 0 0 3 4 4 4 4 4 4 4 4 4 3 2 0 0 0 0 5 0 2 0 3 5 0 0 0 1 1 1 1 1
1 1 1 1 1 3 3 3 3 3 3 3 3 3 3 3 3 3 3 3 3 3 3 3 3 3 3 3 3 3 3 3 3 3 3 3 3 3 3 3 3 3 3 3 3 1 1 1 1 1
1 1 1 1 1 0 0 0 2 5 3 0 0 0 5 2 0 0 0 5 3 0 2 0 5 0 0 0 0 2 3 0 0 0 5 0 2 0 0 5 3 0 0 2 5 1 1 1 1 1
1 1 1 1 1 0 0 2 5 0 3 0 0 5 2 0 0 0 5 0 3 2 0 5 0 0 0 0 2 0 3 0 0 5 0 2 0 0 5 0 3 0 2 5 0 1 1 1 1 1
1 1 1 1 1 0 2 5 0 0 3 0 5 2 0 0 0 5 0 0 3 0 5 0 0 0 0 2 0 0 3 0 5 0 2 0 0 5 0 0 3 2 5 0 0 1 1 1 1 1
1 1 1 1 1 2 5 0 0 0 3 5 2 0 0 0 5 0 0 2 3 5 0 0 0 0 2 0 0 0 3 5 0 2 0 0 5 0 0 0 3 5 0 0 0 1 1 1 1 1
1 1 1 1 1 1 1 1 1 1 1 1 1 1 1 1 1 1 1 1 1 1 1 1 1 1 1 1 1 1 1 1 1 1 1 1 1 1 1 1 1 1 1 1 1 1 1 1 1 1
1 1 1 1 1 1 1 1 1 1 1 1 1 1 1 1 1 1 1 1 1 1 1 1 1 1 1 1 1 1 1 1 1 1 1 1 1 1 1 1 1 1 1 1 1 1 1 1 1 1
1 1 1 1 1 1 1 1 1 1 1 1 1 1 1 1 1 1 1 1 1 1 1 1 1 1 1 1 1 1 1 1 1 1 1 1 1 1 1 1 1 1 1 1 1 1 1 1 1 1
1 1 1 1 1 1 1 1 1 1 1 1 1 1 1 1 1 1 1 1 1 1 1 1 1 1 1 1 1 1 1 1 1 1 1 1 1 1 1 1 1 1 1 1 1 1 1 1 1 1
1 1 1 1 1 1 1 1 1 1 1 1 1 1 1 1 1 1 1 1 1 1 1 1 1 1 1 1 1 1 1 1 1 1 1 1 1 1 1 1 1 1 1 1 1 1 1 1 1 1